
     0 0 0 0 0
     0 0 0 0 0 
     0 0 0 0 0
     0 0 0 0 0
     0 0 0 0 0 
=
     2 2 2 2 2
     2 2 2 2 2
     2 2 2 2 2
     2 2 2 2 2
     2 2 2 2 2
=
    8        8
    C   8    C
    8        8

=
     4 4 4 4 4
     4 4 4 4 4

