
     0 0 0 0 0
     0 0 0 0 0 
     0 0 0 0 0
     0 0 0 0 0
     0 0 0 0 0 
=
     2 2 2 2 2
     2 2 2 2 2
     2 2 2 2 2
     2 2 2 2 2
     2 2 2 2 2

=
     4 4 4 4 4
     4 4 4 4 4

=

   D         D
   D         D
   D         D
