
    8        8
    C   8    C
    8        8

=
     0 2 4 6 8
       A C E

=
     4 4 4 4 4
     4 4 4 4 4

