
     0 0 0 0 0
     0 0 0 0 0 
     0 0 0 0 0
     0 0 0 0 0
     0 0 0 0 0 
=
     A A B A A
     A A B A A
     B B B B B
     A A B A A
     A A B A A
=
     2 2 2 2 2
     2 2 2 2 2
     2 2 2 2 2
     2 2 2 2 2
     2 2 2 2 2

=
     4 4 4 4 4
     4 4 4 4 4

